1111111111111111111111111
1000000E0000000C00000C001
1010010100100000101001001
1010010010101010001001001
1P0000000C00C000000000001
1111111111111111111111111