11111111111111111111
1E0000000000000C0001
10100101001000001011
10100100101010100011
100000000C00C0000001
11111111111111111111