111111111111111111111
100000E00M000C0000001
1000100001010100C0001
1P000101C100000100001
111111111111111111111