1111111111111111111111111
100000100000000C000000001
100000E00M000001010001001
1000100001010100010010101
1P000101C100C000000000101
1111111111111111111111111