1111111111111111111111111
100000000000000C000000001
100000000M000001010001001
1000100101010100010010101
1P000101C100C0000000001E1
1111111111111111111111111