1111111111111111111111111
100000000000000C00000C001
1000001000100000101001001
1010010E01010100010010001
1P100101C100C00000M000001
1111111111111111111111111