111111111111111111111
1000001E1101000000001
100000000M01010000001
1P01100C1000000000001
111111111111111111111