111111111111111111111
100000E00M00000000001
100010000101010000001
1P000101C100000100001
111111111111111111111