111111111111111111111
1E000000000M000000001
111111101111111111101
1C000000000000P000001
111111111111111111111