1111111111111111111111111
1000000M0000000C000000001
1000000000000001010000001
10001000M1010100010010101
1P000101C100C0000000001E1
1111111111111111111111111