111111111111111111111
100000E00M00000000001
100010000101010000001
1P01101C1000001000001
111111111111111111111