111111111111111111111
1E0000000000000000001
1111011000C0000100001
1C0000000M0000P000001
111111111111111111111